▤▤▤▤▤▤▤▤▤▤▤▤▤▤▤▤▤▤▤▤▤▤▤▤▤▤▤▤▤▤▤▤▤▤▤▤▤▤▤▤▤▤▤▤▤▤▤▤▤▤▤▤▤▤▤▤▤▤▤▤▤▤▤▤▤▤▤▤▤▤▤▤▤▤▤▤▤▤▤▤
▤                                                                              ▤
▤                                                                              ▤
▤                                                                              ▤
▤                                                                              ▤
▤                                                    ☠                        ▤
▤                                                                              ▤
▤                                                                              ▤
▤                                                                              ▤
▤                     ☠                                                       ▤
▤                                                                              ▤
▤                                                                              ▤
▤                                                                              ▤
▤                                                                              ▤
▤                                                                              ▤
▤                                                                              ▤
▤                       ☠                                                     ▤
▤                                                                              ▤
▤                                                                              ▤
▤                                                                              ▤
▤                                                                              ▤
▤                                                  ☠                          ▤
▤                                                                              ▤
▤                                                                              ▤
▤                                                                              ▤
▤                                                                              ▤
▤                                                                              ▤
▤                                                                              ▤
▤                                    ☺                                         ▤
▤▤▤▤▤▤▤▤▤▤▤▤▤▤▤▤▤▤▤▤▤▤▤▤▤▤▤▤▤▤▤▤▤▤▤▤▤▤▤▤▤▤▤▤▤▤▤▤▤▤▤▤▤▤▤▤▤▤▤▤▤▤▤▤▤▤▤▤▤▤▤▤▤▤▤▤▤▤▤▤