▤▤▤▤▤▤▤▤▤▤▤▤▤▤▤▤▤▤▤▤▤▤▤▤▤▤▤▤▤▤▤▤▤▤▤▤▤▤▤▤▤▤▤▤▤▤▤▤▤▤▤▤▤▤▤▤▤▤▤▤▤▤▤▤▤▤▤▤▤▤▤▤▤▤▤▤▤▤▤▤
▤                                                                              ▤
▤                                                                              ▤
▤                                                                              ▤
▤                                                                              ▤
▤                                                    ☠                         ▤
▤                                                                              ▤
▤                                                                              ▤
▤                                                                              ▤
▤                     ☠                                                        ▤
▤                                                                              ▤
▤                                                                              ▤
▤                                                                              ▤
▤                                                                              ▤
▤                                                                              ▤
▤                                                                              ▤
▤                       ☠                                                      ▤
▤                                                                              ▤
▤                                                                              ▤
▤                                                                              ▤
▤                                                                              ▤
▤                                                  ☠                           ▤
▤                                                                              ▤
▤                                                                              ▤
▤                                                                              ▤
▤                                                                              ▤
▤                                                                              ▤
▤                                                                              ▤
▤                                    ☺                                         ▤
▤▤▤▤▤▤▤▤▤▤▤▤▤▤▤▤▤▤▤▤▤▤▤▤▤▤▤▤▤▤▤▤▤▤▤▤▤▤▤▤▤▤▤▤▤▤▤▤▤▤▤▤▤▤▤▤▤▤▤▤▤▤▤▤▤▤▤▤▤▤▤▤▤▤▤▤▤▤▤▤